~ ~~~~~~ ~~
 ~  ~
   # # #~
   # # #  #
   # # #  #
   # ~ #  ~
###########