

   #~# #
   # # #
   # # #
   #   #
###########