.........................
.........................
.........................
.....#......#......#.....
.....#......#......#.....
.....#......#......#.....
.....#......#......#.....
.....#~~~~~~#......#.....
.....#~~~~~~#......#.....
.....#~~~~~~#......#.....
.....#~~~~~~#......#.....
.....#~~~~~~.......#.....
.....###############.....
.........................
.........................
.........................