

  # # #
  # # #
  #~# #
  #~  #
#########