.................................
.................................
.................................
...#...#..........#..............
...#v..#..........#..............
...#v..#..........#..............
...#v..#..........#..............
...#v..#..........#..............
...#...#..........#..............
...#...#..........#..............
...#..............#..............
...################..............
.................................
.................................
.................................
.................................