..........................................
.###......................................
..#.......................................
.#####....................................
.###......................................
.#####....................................
..........................................
.....#....................................
.....##...................................
.....###..................................
.....####.................................
.....#####................................
..........................................
.......##..............##.................
........#.............##..................
........#.########.###....................
..........................................
..........................................
................#.........#...............
................#######.###...............
..........................................
..........................................
..........................................
..........................................
.......#######.##.....########.##.........
.......#######.##.....########.##.........